Tanya Atwater UCSB	Earth Science
Andrew Ballantine UCSB	ERI
Lars Bildsten UCSB	KITP
Jim Boles UCSB	Earth Science
Bradley Cardinale UCSB	EEMB
Jennifer Caselle UCSB	Marine Science Institute
Gautier, Catherine UCSB	Geography
Raymond Smith UCSB	Geography
Mason Dykstra UCSB	Crustal Studies
Hallie Eakin UCSB	Geography
Michael Freeston UCSB	ICESS
William Freudenburg UCSB	Environmental Studies
Michael Goodchild UCSB	Geography
Larry Gurrola UCSB	Crustal Studies
Rachel Haymon UCSB	Earth Science
Trevor Hayton UCSB	Chemistry and Biochemistry
Jacob Israelachvili UCSB	Chemical Engineering
Brenda Johnson UCSB	Library
Matthew Kay UCSB	ERI
Bernard Kirtman UCSB	Chemistry
Charles Kolstad UCSB	Economics and Bren
Helena Kooijman UCSB	Earth Science
Sotiria Lampoudi UCSB	ERI
Jim Langer UCSB	Physics
Marina Levy UCSB	ERI
Bruce Luyendyk UCSB	Earth Science
James Mattinson UCSB	Earth Science
Katrina Michalides UCSB	ERI
Craig Nelson UCSB	EEMB
Norm Nelson UCSB	ERI
John O'Donovan UCSB	Computer Science
Sadie Ryan UCSB	NCEAS
Cyrus Safinya UCSB	Materials and Physics
Diane Schweizer UCSB	ICESS
Seeta Sistla UCSB	ERI
Christopher Sorlien UCSB	ERI
Stacia Gordon UCSB	ERI
Christopher Still UCSB	Geography
David Stoms UCSB	ERI
Zhengming Wan UCSB	ERI
Robert Warner UCSB	EEMB
Douglas Wilson UCSB	Marine Science Institute